wwwwwwwwwwwwwwwwwwww
w  w    w    cw    w
ww   wwwwww   wc   w
w w  ww      wwww ww
wcw  w  cw   w  w  w
w    w  ww  ww  w  w
www  w   ww  w    cw
w cw  w    k w  lwww
w  w  w  wwwww     w
w   l w    w     www
www   w    c  w  c w
w      k ww        w
w   ww   w  www    w
w     k  w  w    wlw
wwwww   ww  www  c w
w c w       cw l w w
w   w   w k  w     w
w   w   ww       www
ww                kw
wwwwwwwwwwwwwwwwwwww