wwwwwwwwwwwwwwwwwwww
w  l   l           w
wk                 w
w       k   c     kw
wk                 w
w                 kw
w     k            w
w          l      kw
w   k  c           w
w                 kw
wk   l l           w
w              k   w
wk          c      w
w        l      k  w
wk                 w
w    l           k w
wk                 w
w                 kw
w     l  l l l    cw
wwwwwwwwwwwwwwwwwwww