wwwwwwwwwwwwwwwwwwww
w wwwww            w
w                  w
w wwwww            w
w k                w
w wwwww            w
w wwwww            w
w k                w
w wwwwwwwww        w
wl       cw        w
wwwwwwwwwww        w
w                  w
w                  w
w                  w
w                  w
w                  w
w                  w
w                  w
w                 cw
wwwwwwwwwwwwwwwwwwww