wwwwwwwwwwwwwwwwwwww
w  wl ww     w  c  w
w  w         w     w
w  w   www      k  w
w     w            w
wwwwwww      w     w
w       w l  wwww  w
wwwww l w    w  c  w
w       w          w
w  w        w      w
w  w    wwwww   wwww
w  wwwwww          w
w     w     wwww   w
wwww  w        w   w
w        k     w   w
w   c w    w w     w
wwwww w    w   www w
w                k w
w   w            wcw
wwwwwwwwwwwwwwwwwwww